0 1 1 0 7 1 1 3 0 0
0 1 1 0 1 1 1 1 1 0
0 0 0 2 0 0 6 0 0 0
1 0 1 0 0 1 1 1 1 1
0 0 3 1 0 0 0 0 0 0
1 2 0 1 0 0 1 1 1 1
1 0 1 1 0 0 0 0 0 0
1 0 1 0 0 8 1 1 1 1
1 8 0 0 1 0 0 0 0 1
5 0 1 0 0 1 1 1 2 4 