0 1 1 1 1 1 1 1 1 1
0 0 0 0 2 0 0 6 0 7
1 1 0 1 1 0 1 1 1 1 
1 1 3 1 0 0 1 1 1 1 
1 1 1 0 0 0 0 8 3 1 
1 1 0 0 1 1 1 1 1 1
0 0 0 0 0 0 0 0 0 1
1 1 1 0 0 0 1 0 0 1
1 1 1 0 0 0 1 1 1 1 
5 0 0 0 0 0 8 2 0 4