0 3 0 0 0 0 0 0 0 0
1 1 1 1 1 1 1 1 1 0
0 0 2 0 0 0 0 0 0 0
0 0 1 1 1 1 1 1 0 0
0 0 1 0 2 0 4 1 3 0
1 2 1 1 0 1 1 1 1 0
7 0 8 0 6 0 0 1 0 0
1 1 1 1 1 1 1 1 0 1
8 0 0 1 0 0 0 1 0 1
5 1 0 0 0 1 0 0 0 1